
首页: GET /
注册: GET POST /register
登录: GET POST /login
注销: GET /logout
用户资料页: GET /<username>

获取Todo: GET /<username>/todos
创建Todo: POST /<username>/todos/add
删除Todo: GET /<username>/todos/delete/<string:todo_id>
更改Todo状态-->undo: POST /<username>/todos/undo/<string:todo_id>
更改Todo状态-->done: POST /<username>/todos/done/<string:todo_id>

获取日志: GET /<username>/blogs
创建日志: GET /<username>/editor
        POST /<username>/blogs/add
修改日志: GET /<username>/editor/<string:blog_id>
        POST /<username>/blogs/modify/<string:blog_id>
删除日志: POST /<username>/blogs/delete/<string:blog_id>
增加评论: POST /article/<string:blog_id>/add_comment
删除评论: POST /article/<string:blog_id>/del_comment/<string:comment_id>
日志: GET /article/<string:blog_id>


获取评论: GET /api/comments
创建评论: POST /api/blogs/:blog_id/comments
删除评论: POST /api/comments/:comment_id/delete
创建新用户: POST /api/users
获取用户: GET /api/users
----管理页面包括:
评论列表页: GET /manage/comments
日志列表页: GET /manage/blogs
创建日志页: GET /manage/blogs/create
修改日志页: GET /manage/blogs/
用户列表页: GET /manage/users

